1111111111111111111111111111111111
1111111111111111111111111111111111
1111111111111111111111111111111111
1110000000001000000000000000000111
1110000000001000000000000000000111
1110000001000000001000000010000111
1110000001000000001000000010000111
1110000111001111111111111110000111
1110000100000000000001000000000111
1110000100000000000001000000000111
1110000100000000100000000000000111
1110000100011111111100011111111111
1110000100000000000100011111111111
1110001100111010000100011111111111
1110000000001010000100011111111111
1110000000001111100000000000000111
1110000000000000000000000000000111
1110000000000000000000010000000111
1110001111111111100011111111000111
1110000000100000000010000001000111
1110000000100000000010000001000111
1110000111100011111110000001000111
1110000000000000000100000000000111
1110000000000000000100111100000111
1110001000000000000100100000000111
1110001000111111100000100000000111
1110001000000000100000000000000111
1110001000000000100000000111111111
1110001111110000100000000111111111
1110000000000000100000000111111111
1110000000000000100000000111111111
1111111111111111111111111111111111
1111111111111111111111111111111111
1111111111111111111111111111111111
